H,0,X,X,0,0,T,0,0,0,T
0,0,X,0,X,T,0,0,T,0,T
0,T,X,0,T,0,T,0,X,T,0
0,T,0,0,0,0,0,0,X,T,X
0,0,0,X,X,T,X,0,0,0,T